8 10
0 1 1 1 1 1 1 0 0 0
1 1 0 0 0 0 1 0 0 0
1 0 0 0 0 3 1 1 1 1
1 0 1 0 3 5 3 2 0 1
1 0 0 0 5 2 4 0 0 1
1 1 1 0 0 1 2 0 0 1
0 0 1 1 1 1 0 0 0 1
0 0 0 0 0 1 1 1 1 1
